111111111111111111111111111111111
10010000000C000000000001111111111
100001111100111111110001111111111
1P0011000000111111CCCCC1111111111
111111100001111111100001111111111
111111011111100000000000000000001
111110110111100000000000000000001
111111001111000000000000000000001
111111100E00000000000000000000011
111111111111111111111111111111111
